
111111111111111111111
1W0000000000000000001
100000000111110000001
100000000100010000001
100000000100010000001
100000000110110000001
100000000000000000001
100011100000000011101
100010000000000010001
100011100000000011101
100000000000000000001
100000011101111000001
100000010000001000001
100000010000001000001
100000011111111000001
100000000000000000001
100011100000000011101
100010000000000000101
100011100000000011101
100000000000000000001
111111111111111111111
