NO bonus/res/textures/wood1.xpm
WE bonus/res/textures/brick.xpm
SO bonus/res/textures/grass.xpm
EA bonus/res/textures/wood.xpm

F 0, 0, 0
C 0, 0, 0

111111111111111111111111
1E000000000000  0000001
10000000011111000000111
100000000D000D0000001
 10000001100110010001111111
1      0 0000000D01110000001
100000000111000010001111111
1000111000000000111011
100010D0000000001000101
1000111000000000111011
100000000000000000001
100000011111111000001
100000010000001000001
100000010000001000001
1000000111D1111000001
100000000000000000001
100011100000000011101
100010000000000000101
100011100000000011101
111111111111111111111
