NO bonus/res/textures/wood1.xpm
SO bonus/res/textures/grass.xpm
WE bonus/res/textures/brick.xpm
EA bonus/res/textures/wood.xpm

F 0, 0, 0
C 0, 0, 0

111111111111111111111
100001000001E01001001
10000000000000D00D001
100001000000001001001
111111111111111111111
