NO bonus/res/textures/wood1.xpm
SO bonus/res/textures/grass.xpm
WE bonus/res/textures/wood.xpm
EA bonus/res/textures/brick.xpm

F 0, 0, 0
C 0, 0, 0

111111111111111111111
100000000001N01001001
10000000000000D00D001
100000000000001001001
111111111111111111111
