NO bonus/res/textures/wood1.xpm
WE bonus/res/textures/brick.xpm
SO bonus/res/textures/grass.xpm
EA bonus/res/textures/wood.xpm

F 120, 0, 255
C 0, 0, 255

111111111111111111111
1E0000000000000000001
100000000111110000001
100000000D000D0000001
100000000100010000001
100000000D01110000001
100000000111000000001
100011100000000011101
100010D00000000010001
100011100000000011101
100000000000000000001
100000011111111000001
100000010000001000001
100000010000001000001
1000000111D1111000001
100000000000000000001
100011100000000011101
100010000000000000101
100011100000000011101
111111111111111111111