NO bonus/res/textures/brick.xpm
WE bonus/res/textures/wood1.xpm
SO bonus/res/textures/grass.xpm
EA bonus/res/textures/wood.xpm

F 0, 0, 0
C 0, 10, 0

111111111111111111111  11111111111111111
1000000000000000000N1  10000000000000001
100000011111111000001  10000000000000001
10000001000000D0000011110000000000000001
1000000100000010000000000000000000000001
1000000111D11110000011110000000000000001
100000000000000000001  10000000000000001
100011100000000011101  10000000000000001
100010000000000000101  10000000000000001
100011100000000011101  10000000000000001
111111111111111111111  11111111111111111