NO ./res/textures/NO.xpm
SO ./res/textures/SO.xpm
WE ./res/textures/WE.xpm
EA ./res/textures/EA.xpm

F 230,	40,	255
C 10, 240, 1

111111
100001
100001
111101
