NO ./res/textures/NO.xpm
SO ./res/textures/SO.xpm
WE ./res/textures/WE.xpm
EA ./res/textures/EA.xpm

F 255,	255, 255
C 0, 0, 255

11111111
10000001
10000001
10000001
100W0001
10000001
11111111
