NO ./res/textures/NO.xpm
SO ./res/textures/SO.xpm
WE ./res/textures/WE.xpm
EA ./res/textures/EA.xpm

F 255, 255, 255
C 0, 0, 255

111111
100001
100001
111101
