NO ./res/textures/NO.xpm
SO ./res/textures/SO.xpm
WE ./res/textures/WE.xpm
EA ./res/textures/EA.xpm

F 255,	255, 255
C 0, 0, 255

111111111
100111001
110000001111
100000000001
100011101111
100000001
10000N001
100000001
100010001
111111111
