NO ./res/textures/sprites/orb.xpm
SO ./res/textures/SO.xpm
WE ./res/textures/WE.xpm
EA ./res/textures/EA.xpm

F 255,	255, 255
C 0, 0, 255


   111
   101
   101
   101
   101
111101111
100101001
110000001111
100000000001
100010001111
100000001
10000N001
100000001
100010001
111111111
