NO ./res/textures/NO.xpm
SO ./res/textures/SO.xpm
WE ./res/textures/WE.xpm
EA ./res/textures/EA.xpm

F 255,	255, 255
C 0, 0, 255


111111111111111        11111
100000000000001        11011
100000000000001        11011
100000000000001        11011
100000W00000001        11011
100000000000001        11011
100000000000001        11011
111111111111111        11111