NO ./res/textures/wood1.xpm
SO ./res/textures/grass.xpm
WE ./res/textures/wood.xpm
EA ./res/textures/brick.xpm

F 0, 0, 0
C 0, 0, 0


111111111111111111111
100000000001N00000001
100000000000000000001
111111111111111111111
